systemd	系统服务
dbus	系统服务
mpfr	系统库
gmp	系统库
libselinux	系统库
pcre2	系统库
libsepol	系统库
gdbm	系统库
libxcrypt	系统库
expat	系统库
libffi	系统库
ncurses	系统库
libnsl2	系统库
sqlite	系统库
libtirpc	系统库
zlib	系统库
libverto	系统库
pcre	系统库
libsigsegv	系统库
libcap	系统库
pam	系统库
libcap-ng	系统库
libutempter	系统库
libunistring	系统库
nettle	系统库
p11-kit	系统库
libtasn1	系统库
libgcrypt	系统库
gnutls	系统库
libgpg-error	系统库
libidn2	系统库
lz4	系统库
libseccomp	系统库
libunistring	系统库
nettle	系统库
p11-kit	系统库
libtasn1	系统库
json-c	系统库
libaio	系统库
glib2	系统库
popt	系统库
cracklib	系统库
libdb	系统库
libpwquality	系统库
bash	系统工具
tzdata	系统工具
chkconfig	系统工具
xz	系统工具
readline	系统工具
krb5	系统工具
coreutils	系统工具
gawk	系统工具
grep	系统工具
keyutils	系统工具
sed	系统工具
texinfo	系统工具
acl	系统工具
attr	系统工具
util-linux	系统工具
which	系统工具
shadow-utils	系统工具
crypto-policies	系统工具
lvm2	系统工具
cryptsetup	系统工具
elfutils	系统工具
crypto-policies	系统工具
findutils	系统工具
procps-ng	系统工具
gzip	系统工具
ca-certificates	系统工具
audit	应用服务
redis	应用服务
openssl	应用库
fuse	应用库
libsemanage	应用库
bzip2	应用工具
e2fsprogs	应用工具
zstd	应用工具
device-mapper-persistent-data	应用工具
pkgconf	应用工具
bash-completion	应用工具
authselect	应用工具
logrotate	应用工具
basesystem	固化列表
filesystem	固化列表
setup	固化列表
anolis-release	固化列表
kmod	固化列表
initscripts	固化列表
squashfs-tools	固化列表
dracut	固化列表
libdnf	固化列表
dnf	固化列表
os-prober	固化列表
dnf-plugins-core	固化列表
grub2	固化列表
efibootmgr	固化列表
efi-rpm-macros	固化列表
efivar	固化列表
grubby	固化列表
rootfiles	固化列表
shim	固化列表
linux-firmware	固化列表
microcode_ctl	固化列表
rdma-core	固化列表
fwupd	固化列表
kernel	固化列表
kexec-tools	固化列表
publicsuffix-list	固化列表
shared-mime-info	固化列表
langpacks	固化列表
glibc	编译工具链
gcc	编译工具链
python3	编程语言
python-setuptools	编程语言
python-pip	编程语言
libselinux	安全组件
libsepol	安全组件
shadow-utils	安全组件
pam	安全组件
libseccomp	安全组件
libgcrypt	安全组件
selinux-policy	安全组件
audit	安全组件
libsemanage	安全组件
